XXX     WX        WX ,
XSS  WX  X A     SSX ,
        SX    XX SSX ,
XXXXX    X   SS   X  ,
    X X  X      X SS ,
W  XXXXXXXXXXXXXXXXX ,
X     X     W   X    ,
XX    XS    W  XXS   ,
  XX   X  XXXXXXXW X ,
XXX    X WX       XX ,
X    X    X    X  SS ,
  X  XX   X X XX  XX ,
 XXX X    X    X X X ,
X         XS    XXX  ,
   WXXXXXXX  XX    X ,
  X    X     X XX    ,
 XX    X  X X   X    ,
W XXX  X XX XX X X   , 
X  X   X  X X XX XX  ,
X     WXX        S X 